Level 1:
6 6
0 0 0 0 0 2
0 1 1 1 1 0
0 0 0 0 0 0
0 1 1 0 1 0
0 0 0 0 1 0
0 0 0 0 0 0
2 2

Level 2:
6 6
0 0 0 0 0 2
0 1 1 1 1 0
0 3 0 0 0 0
0 1 1 0 1 0
0 0 0 0 1 0
0 0 0 0 0 0
2 2

Level 3:
6 6
0 2 0 0 0 2
0 1 1 1 1 0
0 3 0 0 2 0
0 1 1 0 1 0
0 2 0 0 1 0
0 0 0 0 2 0
2 2

